-------------------------------------------------------------------------------------------------------------------
-------------------------------------------------------------------------------------------------------------------
-------------------------------------------------------------------------------------------------------------------
-------------------------------------------------------------------------------------------------------------------
-------------------------------------------------------------------------------------------------------------------
-------------------------------------------------------------------------------------------------------------------
-------------------------------------===----==++==-----------------------------------------------------------------
------------------------------==+*#%@@%##%%@@@@@%#*+=------===---------------=*=-----------------------------------
-------------------------=++=*+**#%%+*%@@@@@@@@@@@+------=##%=----------------=+*+=--------------------------------
-----------------------=**##**+*#%#=-===#@@@@@@@@@*-----------------=#*===--+#%@@@@*=----=*++=---------------------
--------------==------+%*%@%+#*+#@@@+=--=%@@@@@@##--=-------====----**=-#%##@@@@@@@@@@@@###@@%*+=---=++------------
-----------#@@@@@@@@@@@@@#**+*#%##+*@#=-=%@@@@%#==--------=#@@@@@*#+%@@@@@#@@@@@@@@@@@@@@@@@@@@@@@@@@@@#==---------
----------+%@@@@@@@@@@@@@@@@@@@%#+*%@%=--#@@+---=##+----=*@@%#@@%%@@@@@@@@@@@@@@@@@@@@@@@@@@@@@@@@@@@@%=++---------
---------=#@@@%#%@@@@@@@@@@@@%---+%@+==---**---------===#@@%=%@@@@@@@@@@@@@@@@@@@@@@@@@@@@@@@@%%%*+##*=------------
---------=+**=---=*@@@@@@@@@@@#+=+@@@@#=------------=##-=+#*+@@@@@@@@@@@@@@@@@@@@@@@@@@@@@@@@+=--=%%+--------------
---------==--------#@@@@@@@@@@@@%%@@@@@*=----------=**@*%@@@@@@@@@@@@@@@@@@@@@@@@@@@@@@@@@@@@@%+--=+---------------
-------------------=%@@@@@@@@@@@@@@@@++#+------------=#@@@@@@@@@%%@@@%@@%@@@@@@@@@@@@@@@@@@@@@*=-------------------
-------------------*@@@@@@@@@@@@@@@+==--------------#@@@+*%*@@%++=+@#+%@@@@@@@@@@@@@@@@@@@@@#==*+------------------
-------------------*@@@@@@@@@@@@@#=----------------=#@@====+-#*@@@@@@+#@@@@@@@@@@@@@@@@@@#*#*-=#=------------------
--------------------*@@@@@@@@@@@*=-----------------=*@@@@@*==*==+@@@@@@@@@@@@@@@@@@@@@@@@@+-=*=--------------------
---------------------+%@@@@**==#------------------=#@@@@@@@@@@@@%@@@@#%@@@@@@@@@@@@@@@@@@@#------------------------
---------------------=+#@@*-===+=----------------=#@@@@@@@@@@@@@@#%@@@@@+-=#@@@@@#@@@@@%#**------------------------
------------------------+%@#@*-=+++=-------------=#@@@@@@@@@@@@@@@*#@@%*=---*@@#=-+#@@%+=-+*-----------------------
---------------------------=+%*-=++=-------------=#@@@@@@@@@@@@@@@@%**=-----=#%----=%#@#--+*+----------------------
-----------------------------==+%@@@@%+=----------=*@@@%%@@@@@@@@@@@@#=------=++---=+%+--**=*=---------------------
-------------------------------+@@@@@@@@+----------------*@@@@@@@@@@*---------------*%=*@@#**+---------------------
-------------------------------%@@@@@@@@@@@%=------------=#@@@@@@@@=-----------------+%=++*#===#@@#=+=-------------
-------------------------------+@@@@@@@@@@@@#=------------+@@@@@@@@=-------------------====+=-===*+*=--------------
-------------------------------=*@@@@@@@@@@%=-------------*@@@@@@@@=*#+--------------------=#%@%=%*----------------
---------------------------------=#@@@@@@@@#--------------+@@@@@@#==@#------------------=*#@@@@@@@%+---==----------
----------------------------------#@@@@@@*=----------------%@@@@%+-=*=-----------------=#@@@@@@@@@@%+--------------
---------------------------------=%@@@@@#=-----------------=@@@%+-----------------------*@@@@@@@@@@%+--------------
---------------------------------=%@@@%+=-------------------===-------------------------=+==--=#@@%=-----==--------
---------------------------------+@@@#=---------------------------------------------------------==------=*+--------
---------------------------------=%@%-----------------------------------------------------------------+%=----------
---------------------------------=%@*-=----------------------------------------------------------------------------
----------------------------------=#*===---------------------------------------------------------------------------
-------------------------------------------------------------------------------------------------------------------
-------------------------------------------------------------------------------------------------------------------
-------------------------------------------------------------------------------------------------------------------
-------------------------------------------------------------------------------------------------------------------
-------------------------------------------------------------------------------------------------------------------
-------------------------------------------------------------------------------------------------------------------
-------------------------------------------------------------------------------------------------------------------